F  127, 127, 127


NO   png/cheap-sprite.png

EA   png/cheap-ea.png
C  31 , 133, 222
WE   png/mmap-plr.png

R   1024  1024
SO   xpm/cheap-so.xpm


11111111111
10000100001
10001110001
10011111001
10010001001
10111111101
10000000001
11111111111
10000000001
10000000001
10000000001
10000000001
10001010001
10011011001
10001N10001
10011111001
10000100001
10000000001
11111111111