
R 256 256

NO xpm/brick-wall.xpm
SO xpm/brick-wall.xpm
EA xpm/brick-wall.xpm
WE xpm/brick-wall.xpm

C  31 , 133, 222
F  127, 127, 127

  1111111
 100000001
10000000001
10001110001
10011111001
1E011111001
10011111001
10001110001
10000000001
 100000001
  1111111
