
R 1024 1024

NO xpm/brick-wall.xpm
SO xpm/brick-wall.xpm
EA xpm/brick-wall.xpm
WE xpm/brick-wall.xpm

C  31 , 133, 222
F  131, 100, 100


   111111111111
  10000000000001
 100111111111101
 101000000001101
 1000000000111001
 1000001111000010111
100010000000110001001
 10000011110011100011
  10001    11   110001
   101            11011
 1110111111111 11100000111
100000000000001000101100001
100000000000001011100110111
100000011000001000010110101
100000011011111011000000001
100000000000001011111001111
100E00000100001001000000001
100000000100001100011111101
100000000111111011011001011
100000000000001000000100001
111111000000001011001101011
100001000000001000000001001
100000000000000000000001001
 1111111111111111111111111